F  255,100,20
C 171,154,137

NO textures/bricks/we.xpm
SO textures/bricks/no.xpm
WE textures/bricks/tile.xpm
EA textures/bricks/es.xpm

1111111111111111111
1001001001001001001
1001001001001001001
1001001001001001001
1001001000001001001
100000000S000000001
1000011110111000001
1111100000000001111111
    100000001100000001
1111111100111111111111
1111111100111111111
1001001001001001001
1001001001001001001
1001001001001001001
1001001000001001001
1000000000000000001
1000011110111000001
1111100000000001111111
    100000001100000001
1111111110111111111111
1111111100111111111
1001001001001001001
1001001001001001001
1001001001001001001
1001001000001001001
1000000000000000001
1000011110111000001
1111100000000001111111
    100000001100000001
1111111110111111111111
1111111110111111111111
1111111111111111111